langName=English
title=YouTube MP3 downloader
style=Style:
color=Color:
defaultDownloadFolder=Default download folder:
language=Language:
OK=OK
settings=Settings
downloads=Downloads:
vTitle=Title
vStatus=Status
vProgress=Progress
vFile=File
download=Download
newDownloadTitle=Download MP3
link=Link:
quality=Quality:
invalidYTLink=Invalid YouTube link!
allFiles=All files
statusFileDownload=Downloading file...
statusEncoding=Encoding to MP3...
done=Done.
cancelled=Cancelled.
cancel=Cancel
error=Error.
devBy=Developed by: Robot9706
uses=The following libraries are used:
colorStyle_Black=Black
colorStyle_White=White
colorStyle_Silver=Silver
colorStyle_Blue=Blue
colorStyle_Green=Green
colorStyle_Lime=Lime
colorStyle_Teal=Teal
colorStyle_Orange=Orange
colorStyle_Brown=Brown
colorStyle_Pink=Pink
colorStyle_Magenta=Magenta
colorStyle_Purple=Purple
colorStyle_Red=Red
colorStyle_Yellow=Yellow
themeStyle_Light=Light
themeStyle_Dark=Dark
encToMp3=Encode to MP3: