langName=Magyar
title=YouTube MP3 letöltõ
style=Stílus:
color=Szín:
defaultDownloadFolder=Alapértelmezett letöltési mappa:
language=Nyelv:
OK=OK
settings=Beállítások
downloads=Letöltések:
vTitle=Cím
vStatus=Állapot
vProgress=Folyamat
vFile=Fájl
download=Letöltés
newDownloadTitle=MP3 letöltése
link=Link:
quality=Minõség:
invalidYTLink=Hibás YouTube link!
allFiles=Minden fájl
statusFileDownload=Fájl letöltése...
statusEncoding=Kódolás MP3-ba...
done=Kész.
cancelled=Megszakítva.
cancel=Megszakít
error=Hiba.
devBy=Készítette: Robot9706
uses=A következõket használja:
colorStyle_Black=Fekete
colorStyle_White=Fehér
colorStyle_Silver=Ezüst
colorStyle_Blue=Kék
colorStyle_Green=Zöld
colorStyle_Lime=Lime
colorStyle_Teal=Zöldes kék
colorStyle_Orange=Narancs
colorStyle_Brown=Barna
colorStyle_Pink=Rózsaszín
colorStyle_Magenta=Bíborvörös
colorStyle_Purple=Lila
colorStyle_Red=Piros
colorStyle_Yellow=Sárga
themeStyle_Light=Világos
themeStyle_Dark=Sötét